Banjara Indian Cuisine	/biz/banjara-indian-cuisine-toronto?osq=Indian+Food	338
Bindia Indian Bistro	/biz/bindia-indian-bistro-toronto?osq=Indian+Food	112
Bhoj Indian Cuisine	/biz/bhoj-indian-cuisine-toronto-2?osq=Indian+Food	34
Indian Roti House	/biz/indian-roti-house-toronto?osq=Indian+Food	143
Utsav	/biz/utsav-toronto?osq=Indian+Food	97
Indian Grill	/biz/indian-grill-toronto?osq=Indian+Food	54
Gandhi Cuisine	/biz/gandhi-cuisine-toronto-2?osq=Indian+Food	242
Little India Restaurant	/biz/little-india-restaurant-toronto?osq=Indian+Food	320
Saffron Spice Kitchen	/biz/saffron-spice-kitchen-toronto?osq=Indian+Food	86
Pukka	/biz/pukka-toronto?osq=Indian+Food	112
The Tiffin Box	/biz/the-tiffin-box-toronto?osq=Indian+Food	33
The Great Maratha	/biz/the-great-maratha-toronto-2?osq=Indian+Food	30
Regency Restaurant	/biz/regency-restaurant-toronto?osq=Indian+Food	52
Mother India	/biz/mother-india-toronto?osq=Indian+Food	172
Curry & Co	/biz/curry-and-co-toronto?osq=Indian+Food	24
Curry Twist Restaurant	/biz/curry-twist-restaurant-toronto?osq=Indian+Food	98
Tibet Kitchen	/biz/tibet-kitchen-toronto?osq=Indian+Food	162
Lageez	/biz/lageez-toronto?osq=Indian+Food	38
Madras Masala	/biz/madras-masala-toronto?osq=Indian+Food	136
The Famous Indian Cuisine	/biz/the-famous-indian-cuisine-toronto?osq=Indian+Food	43
Ji	/biz/ji-toronto?osq=Indian+Food	24
Kathmandu Restaurant	/biz/kathmandu-restaurant-toronto-2?osq=Indian+Food	35
Bukhara Grill	/biz/bukhara-grill-toronto?osq=Indian+Food	45
Feast of Dilli	/biz/feast-of-dilli-toronto?osq=Indian+Food	50
Sher-E-Punjab	/biz/sher-e-punjab-toronto?osq=Indian+Food	62
The Veggie Thali	/biz/the-veggie-thali-toronto?osq=Indian+Food	35
Lahore Tikka House	/biz/lahore-tikka-house-toronto?osq=Indian+Food	399
Indian Crown	/biz/indian-crown-toronto?osq=Indian+Food	11
Aroma Fine Indian Cuisine	/biz/aroma-fine-indian-cuisine-toronto?osq=Indian+Food	145
Mayur Fine Indian Cuisine	/biz/mayur-fine-indian-cuisine-toronto?osq=Indian+Food	30
TYC - The Yellow Chilli - By Sanjeev Kapoor	/biz/tyc-the-yellow-chilli-by-sanjeev-kapoor-toronto?osq=Indian+Food	3
Kothur Indian Cuisine	/biz/kothur-indian-cuisine-toronto?osq=Indian+Food	59
Bombay Street Food	/biz/bombay-street-food-toronto?osq=Indian+Food	88
The Copper Chimney	/biz/the-copper-chimney-toronto?osq=Indian+Food	69
309 Dhaba Indian Excellence	/biz/309-dhaba-indian-excellence-toronto?osq=Indian+Food	129
Roti Cuisine of India	/biz/roti-cuisine-of-india-toronto?osq=Indian+Food	79
Vindaloo Indian Cuisine	/biz/vindaloo-indian-cuisine-toronto?osq=Indian+Food	27
Cinamon Indian Bistro	/biz/cinamon-indian-bistro-toronto?osq=Indian+Food	52
Suksi Biryani House	/biz/suksi-biryani-house-toronto-2?osq=Indian+Food	55
Colaba Junction	/biz/colaba-junction-toronto?osq=Indian+Food	35
South Indian Dosa Mahal Restaurant	/biz/south-indian-dosa-mahal-restaurant-toronto?osq=Indian+Food	64
The Host	/biz/the-host-toronto-2?osq=Indian+Food	85
Rickshaw Bar	/biz/rickshaw-bar-toronto?osq=Indian+Food	76
Delhi Bistro	/biz/delhi-bistro-toronto?osq=Indian+Food	28
Tich Modern Indian Cuisine	/biz/tich-modern-indian-cuisine-toronto?osq=Indian+Food	55
King Palace	/biz/king-palace-toronto?osq=Indian+Food	95
Udupi Palace	/biz/udupi-palace-toronto?osq=Indian+Food	152
Himalayan Kitchen	/biz/himalayan-kitchen-toronto?osq=Indian+Food	46
Suruthis Take Out & Catering	/biz/suruthis-take-out-and-catering-toronto?osq=Indian+Food	4
King Place	/biz/king-place-toronto?osq=Indian+Food	31
Motimahal	/biz/motimahal-toronto?osq=Indian+Food	72
Maurya East Indian Roti	/biz/maurya-east-indian-roti-toronto-3?osq=Indian+Food	24
Glory Of India Roti Cuisine	/biz/glory-of-india-roti-cuisine-toronto?osq=Indian+Food	42
Savera Indian Cuisine	/biz/savera-indian-cuisine-toronto?osq=Indian+Food	47
Earth Indian	/biz/earth-indian-toronto-2?osq=Indian+Food	29
Mt Everest Restaurant	/biz/mt-everest-restaurant-toronto-2?osq=Indian+Food	72
Nawab Express On Avenue	/biz/nawab-express-on-avenue-toronto?osq=Indian+Food	13
Indian Street Food Company	/biz/indian-street-food-company-toronto?osq=Indian+Food	47
Marigold Indian Bistro	/biz/marigold-indian-bistro-toronto?osq=Indian+Food	58
Makkah Restaurant	/biz/makkah-restaurant-toronto-2?osq=Indian+Food	62
Curry Kitchen	/biz/curry-kitchen-toronto?osq=Indian+Food	30
Bombay Chowpatty	/biz/bombay-chowpatty-toronto?osq=Indian+Food	37
Matagali Restaurant	/biz/matagali-restaurant-toronto?osq=Indian+Food	49
Butter Chicken Factory	/biz/butter-chicken-factory-toronto?osq=Indian+Food	69
Maezo	/biz/maezo-toronto-5?osq=Indian+Food	31
North of Bombay	/biz/north-of-bombay-toronto?osq=Indian+Food	33
Karaikudi	/biz/karaikudi-toronto?osq=Indian+Food	79
Kamasutra Indian Restaurant & Wine Bar	/biz/kamasutra-indian-restaurant-and-wine-bar-toronto?osq=Indian+Food	82
OM Restaurant and Bar	/biz/om-restaurant-and-bar-toronto?osq=Indian+Food	41
Chandni Chowk Restaurant	/biz/chandni-chowk-restaurant-toronto?osq=Indian+Food	21
Alis Tandoori Curry House	/biz/alis-tandoori-curry-house-toronto?osq=Indian+Food	10
Bombay Palace	/biz/bombay-palace-toronto?osq=Indian+Food	46
Shahi The Royal Roti	/biz/shahi-the-royal-roti-toronto-2?osq=Indian+Food	12
Empire Grill Indian Cuisine & Wine Bar	/biz/empire-grill-indian-cuisine-and-wine-bar-toronto?osq=Indian+Food	9
Lotus Garden Hakka Indian Style Chinese	/biz/lotus-garden-hakka-indian-style-chinese-toronto?osq=Indian+Food	77
Gautama	/biz/gautama-toronto?osq=Indian+Food	46
Taste Of Tandooree And Sweets	/biz/taste-of-tandooree-and-sweets-toronto?osq=Indian+Food	4
Roti Palace of India	/biz/roti-palace-of-india-toronto?osq=Indian+Food	9
Leela By Amaya	/biz/leela-by-amaya-toronto?osq=Indian+Food	14
Rashnaa Restaurant	/biz/rashnaa-restaurant-toronto-2?osq=Indian+Food	43
Siddartha	/biz/siddartha-toronto?osq=Indian+Food	15
Pili Pili	/biz/pili-pili-toronto?osq=Indian+Food	35
Butter Chicken Roti	/biz/butter-chicken-roti-toronto-2?osq=Indian+Food	56
Eastern Twist	/biz/eastern-twist-toronto?osq=Indian+Food	38
Karmas Kitchen	/biz/karmas-kitchen-toronto?osq=Indian+Food	39
Maja Indian Cuisine	/biz/maja-indian-cuisine-toronto?osq=Indian+Food	18
Shangrila Tibetan & Asian Cuisine	/biz/shangrila-tibetan-and-asian-cuisine-toronto-2?osq=Indian+Food	67
DaiKo Indian Kitchen & Nepali Street Food	/biz/daiko-indian-kitchen-and-nepali-street-food-toronto-4?osq=Indian+Food	26
Bombay Touch	/biz/bombay-touch-vaughan?osq=Indian+Food	28
Masala Kitchen	/biz/masala-kitchen-toronto?osq=Indian+Food	13
T_Bar	/biz/t-bar-toronto?osq=Indian+Food	10
Govindas	/biz/govindas-toronto?osq=Indian+Food	23
Kairali - Taste of Kerala	/biz/kairali-taste-of-kerala-toronto-2?osq=Indian+Food	30
Amma Roti House	/biz/amma-roti-house-toronto?osq=Indian+Food	11
Maroli Indian Restaurant	/biz/maroli-indian-restaurant-toronto-2?osq=Indian+Food	45
Annapurna Vegetarian Restaurant	/biz/annapurna-vegetarian-restaurant-toronto?osq=Indian+Food	29
Pomegranate Restaurant	/biz/pomegranate-restaurant-toronto-2?osq=Indian+Food	138
Indian Biriyani House	/biz/indian-biriyani-house-toronto-2?osq=Indian+Food	45
New Haandi 2000 Restaurant	/biz/new-haandi-2000-restaurant-toronto?osq=Indian+Food	28
Logas Corner	/biz/logas-corner-toronto?osq=Indian+Food	51
Sultan of Samosas	/biz/sultan-of-samosas-toronto?osq=Indian+Food	50
Zam Zam Tikka and Kabab	/biz/zam-zam-tikka-and-kabab-toronto?osq=Indian+Food	13
Buffet Palace	/biz/buffet-palace-toronto?osq=Indian+Food	44
VEDA - Healthy Indian Takeout	/biz/veda-healthy-indian-takeout-toronto-2?osq=Indian+Food	3
Fresh on Spadina	/biz/fresh-on-spadina-toronto-3?osq=Indian+Food	301
High Park Spicy House	/biz/high-park-spicy-house-toronto?osq=Indian+Food	14
Bavu Villas	/biz/bavu-villas-toronto?osq=Indian+Food	7
Jaipur Grill	/biz/jaipur-grill-toronto?osq=Indian+Food	14
Poonam Delite	/biz/poonam-delite-toronto-2?osq=Indian+Food	19
Hakka No. 1	/biz/hakka-no-1-toronto-2?osq=Indian+Food	26
Subiksha Foods	/biz/subiksha-foods-toronto?osq=Indian+Food	7
Punjabi Chaat Palace	/biz/punjabi-chaat-palace-toronto?osq=Indian+Food	2
Pero Restaurant & Lounge	/biz/pero-restaurant-and-lounge-toronto?osq=Indian+Food	47
Baldev Cold Drink House	/biz/baldev-cold-drink-house-toronto?osq=Indian+Food	1
Veda Healthy IndianTakeout	/biz/veda-healthy-indiantakeout-toronto?osq=Indian+Food	15
Bacchus Roti Shop	/biz/bacchus-roti-shop-toronto?osq=Indian+Food	55
Govardhan Thal	/biz/govardhan-thal-toronto?osq=Indian+Food	34
Karahi Point	/biz/karahi-point-toronto?osq=Indian+Food	16
Amaya	/biz/amaya-toronto-6?osq=Indian+Food	33
Amaya Express	/biz/amaya-express-toronto-6?osq=Indian+Food	29
Awai	/biz/awai-toronto?osq=Indian+Food	2
Sohana	/biz/sohana-toronto?osq=Indian+Food	177
Vegetarian Haven	/biz/vegetarian-haven-toronto?osq=Indian+Food	33
Sizzler Kabab	/biz/sizzler-kabab-toronto?osq=Indian+Food	32
Iqbal Kebab & Sweet Centre	/biz/iqbal-kebab-and-sweet-centre-toronto?osq=Indian+Food	21
One Love Vegetarian	/biz/one-love-vegetarian-toronto?osq=Indian+Food	70
Cafelicious	/biz/cafelicious-toronto?osq=Indian+Food	1
Tandori	/biz/tandori-toronto-2?osq=Indian+Food	4
Touch	/biz/touch-toronto?osq=Indian+Food	14
Stratengers Bar & Restaurant	/biz/stratengers-bar-and-restaurant-toronto?osq=Indian+Food	54
Roti Time	/biz/roti-time-toronto?osq=Indian+Food	53
Liberty Paan Corner	/biz/liberty-paan-corner-toronto?osq=Indian+Food	1
Fresh on Bloor	/biz/fresh-on-bloor-toronto-2?osq=Indian+Food	252
Al Aqsa Restaurant	/biz/al-aqsa-restaurant-toronto-2?osq=Indian+Food	2
Chutneys Fine Indian Cuisine	/biz/chutneys-fine-indian-cuisine-etobicoke?osq=Indian+Food	30
Pariwar Restaurant	/biz/pariwar-restaurant-toronto?osq=Indian+Food	15
Michaels West Indian Flavor	/biz/michaels-west-indian-flavor-toronto?osq=Indian+Food	6
Spice Heaven	/biz/spice-heaven-toronto?osq=Indian+Food	3
The Siddhartha	/biz/the-siddhartha-toronto?osq=Indian+Food	34
Hakka Garden Chinese Restaurant	/biz/hakka-garden-chinese-restaurant-toronto?osq=Indian+Food	43
Lahore Chaat & Paan House	/biz/lahore-chaat-and-paan-house-toronto?osq=Indian+Food	5
Doug McNishs Public Kitchen	/biz/doug-mcnishs-public-kitchen-toronto?osq=Indian+Food	56
Malaysian Garam Masala	/biz/malaysian-garam-masala-toronto?osq=Indian+Food	4
Mahas	/biz/mahas-toronto-2?osq=Indian+Food	277
Kabul Express	/biz/kabul-express-toronto?osq=Indian+Food	55
Everest Hakka Cuisine	/biz/everest-hakka-cuisine-etobicoke?osq=Indian+Food	100
Lahore Paan Center	/biz/lahore-paan-center-toronto?osq=Indian+Food	10
New York Subs & Burritos	/biz/new-york-subs-and-burritos-toronto?osq=Indian+Food	73
Exotic Tandoori Restaurant	/biz/exotic-tandoori-restaurant-toronto?osq=Indian+Food	2
East of York Gourmet Food	/biz/east-of-york-gourmet-food-toronto?osq=Indian+Food	15
Mahar Restaurant Incorp	/biz/mahar-restaurant-incorp-toronto?osq=Indian+Food	9
Dum Pukht	/biz/dum-pukht-markham?osq=Indian+Food	79
The Indian Kitchen	/biz/the-indian-kitchen-thornhill?osq=Indian+Food	56
The Spice Room	/biz/the-spice-room-concord?osq=Indian+Food	7
Vatica	/biz/vatica-toronto-2?osq=Indian+Food	5
Lhasa Kitchen	/biz/lhasa-kitchen-toronto?osq=Indian+Food	6
Lolas Kitchen	/biz/lolas-kitchen-toronto?osq=Indian+Food	335
Mildreds Temple Kitchen	/biz/mildreds-temple-kitchen-toronto?osq=Indian+Food	524
Danforth Dragon	/biz/danforth-dragon-toronto?osq=Indian+Food	60
Truly India	/biz/truly-india-toronto?osq=Indian+Food	5
360 Restaurant	/biz/360-restaurant-toronto-2?osq=Indian+Food	621
Hakka #1 Restaurant	/biz/hakka-1-restaurant-toronto?osq=Indian+Food	1
Madinah Grill	/biz/madinah-grill-toronto?osq=Indian+Food	7
Bamiyan Kabob	/biz/bamiyan-kabob-toronto?osq=Indian+Food	67
Kabab & Tikah House	/biz/kabab-and-tikah-house-toronto?osq=Indian+Food	6
Vivah Restaurant	/biz/vivah-restaurant-toronto?osq=Indian+Food	2
Kings Caf	/biz/kings-caf%C3%A9-toronto-2?osq=Indian+Food	120
Kupfert & Kim	/biz/kupfert-and-kim-toronto-7?osq=Indian+Food	83
New Kalyani	/biz/new-kalyani-toronto?osq=Indian+Food	2
Hakka Cottage	/biz/hakka-cottage-toronto?osq=Indian+Food	15
Chandra Mahal Buriyani House	/biz/chandra-mahal-buriyani-house-toronto?osq=Indian+Food	2
Soup It Up	/biz/soup-it-up-toronto-5?osq=Indian+Food	1
Samosa King - Embassy Restaurant	/biz/samosa-king-embassy-restaurant-scarborough?osq=Indian+Food	147
Jikoni Grill	/biz/jikoni-grill-toronto?osq=Indian+Food	2
Norling	/biz/norling-toronto?osq=Indian+Food	56
Agra Fine Indian Cuisine	/biz/agra-fine-indian-cuisine-north-york?osq=Indian+Food	56
La Sani Grill	/biz/la-sani-grill-toronto-2?osq=Indian+Food	50
Abyssinia Ethiopian Restaurant	/biz/abyssinia-ethiopian-restaurant-toronto?osq=Indian+Food	9
Amaya	/biz/amaya-toronto-5?osq=Indian+Food	3
Lahore Grill & Fast Food	/biz/lahore-grill-and-fast-food-toronto?osq=Indian+Food	9
Nitya Restaurant	/biz/nitya-restaurant-toronto?osq=Indian+Food	3
Ashoka Fine Indian Cuisine	/biz/ashoka-fine-indian-cuisine-toronto?osq=Indian+Food	7
Spicy Grill Indo Pak Cuisine	/biz/spicy-grill-indo-pak-cuisine-toronto?osq=Indian+Food	76
Pamier Kabob	/biz/pamier-kabob-toronto?osq=Indian+Food	8
Mr Maharraja Indian Cuisine	/biz/mr-maharraja-indian-cuisine-toronto?osq=Indian+Food	33
Hot Wok	/biz/hot-wok-toronto?osq=Indian+Food	24
Hyderabad Palace	/biz/hyderabad-palace-toronto?osq=Indian+Food	3
The Halal Guys	/biz/the-halal-guys-toronto?osq=Indian+Food	158
Spicy Dragon	/biz/spicy-dragon-toronto?osq=Indian+Food	52
Stratus Restaurant	/biz/stratus-restaurant-toronto-2?osq=Indian+Food	36
Chinese Indian Food	/biz/chinese-indian-food-toronto?osq=Indian+Food	7
Bombay Masala	/biz/bombay-masala-york?osq=Indian+Food	226
Hibiscus	/biz/hibiscus-toronto?osq=Indian+Food	2
Red Hot Tandoori	/biz/red-hot-tandoori-east-york?osq=Indian+Food	77
The Indian Cuisine	/biz/the-indian-cuisine-thornhill?osq=Indian+Food	120
Fresh on Eglinton	/biz/fresh-on-eglinton-toronto-4?osq=Indian+Food	22
Rajdhani Sweets & Restaurant	/biz/rajdhani-sweets-and-restaurant-etobicoke?osq=Indian+Food	15
Blue Water Curry & Roti Restaurant	/biz/blue-water-curry-and-roti-restaurant-north-york?osq=Indian+Food	10
Mainsha Restaurant	/biz/mainsha-restaurant-york?osq=Indian+Food	94
Babu Catering & Take Out	/biz/babu-catering-and-take-out-scarborough-2?osq=Indian+Food	4
Tandoori Flavour	/biz/tandoori-flavour-toronto?osq=Indian+Food	103
Indian Biriyani House	/biz/indian-biriyani-house-toronto?osq=Indian+Food	17
Simba Grill	/biz/simba-grill-east-york?osq=Indian+Food	2
India Kitchen	/biz/india-kitchen-toronto?osq=Indian+Food	1
Caribu West Indian Cuisine	/biz/caribu-west-indian-cuisine-toronto?osq=Indian+Food	2
Naans & More	/biz/naans-and-more-toronto?osq=Indian+Food	7
Amma Takeout & Catering	/biz/amma-takeout-and-catering-toronto?osq=Indian+Food	1
Mistan Indian Food	/biz/mistan-indian-food-toronto?osq=Indian+Food	4
OrderIndianFood	/biz/orderindianfood-toronto?osq=Indian+Food	6
786 Halal Biryani House	/biz/786-halal-biryani-house-toronto?osq=Indian+Food	46
Canbe Foods	/biz/canbe-foods-scarborough-2?osq=Indian+Food	137
Fresh	/biz/fresh-toronto-14?osq=Indian+Food	67
Saravanaa Bhavan	/biz/saravanaa-bhavan-scarborough?osq=Indian+Food	4
Tandoor	/biz/tandoor-toronto?osq=Indian+Food	2
Patio Indian Restaurant	/biz/patio-indian-restaurant-north-york?osq=Indian+Food	4
India House	/biz/india-house-toronto?osq=Indian+Food	48
Bombay Hut	/biz/bombay-hut-toronto?osq=Indian+Food	10
Star of Kingston	/biz/star-of-kingston-toronto?osq=Indian+Food	7
Vinchandra Restaurant & Banquet Hall	/biz/vinchandra-restaurant-and-banquet-hall-toronto?osq=Indian+Food	8
Delicious Shawarma and Falafel	/biz/delicious-shawarma-and-falafel-toronto?osq=Indian+Food	10
Gharoa Restaurant	/biz/gharoa-restaurant-east-york?osq=Indian+Food	8
Ocean Palate	/biz/ocean-palate-markham?osq=Indian+Food	8
Dindigul Thalappakattu Biriyani	/biz/dindigul-thalappakattu-biriyani-toronto?osq=Indian+Food	26
Brar Sweets & Restaurant	/biz/brar-sweets-and-restaurant-etobicoke?osq=Indian+Food	9
Silver Spoon	/biz/silver-spoon-toronto-2?osq=Indian+Food	3
Green Earth Vegetarian Cuisine	/biz/green-earth-vegetarian-cuisine-toronto?osq=Indian+Food	91
Coco Rice Thai Cuisine	/biz/coco-rice-thai-cuisine-toronto?osq=Indian+Food	8
Tanjore Catering	/biz/tanjore-catering-scarborough?osq=Indian+Food	5
Roti Palace	/biz/roti-palace-north-york?osq=Indian+Food	11
Annapurnas Mithai Shoppee	/biz/annapurnas-mithai-shoppee-scarborough?osq=Indian+Food	39
Indian Garden	/biz/indian-garden-toronto?osq=Indian+Food	3
Anjappar Chettinad Restaurant	/biz/anjappar-chettinad-restaurant-scarborough?osq=Indian+Food	103
Laziz Biryani & Kabab	/biz/laziz-biryani-and-kabab-toronto?osq=Indian+Food	10
Al Mustafa Catering	/biz/al-mustafa-catering-mississauga?osq=Indian+Food	2
Naan and Kabob	/biz/naan-and-kabob-toronto-2?osq=Indian+Food	67
Chicken Way	/biz/chicken-way-toronto?osq=Indian+Food	34
Noor Hakkah	/biz/noor-hakkah-toronto?osq=Indian+Food	61
Hopper Hut	/biz/hopper-hut-scarborough?osq=Indian+Food	103
Bengali Sweets and Restaurant	/biz/bengali-sweets-and-restaurant-toronto-2?osq=Indian+Food	9
Biryani	/biz/biryani-toronto?osq=Indian+Food	1
Pizza La Rosa	/biz/pizza-la-rosa-toronto?osq=Indian+Food	62
Millix	/biz/millix-toronto?osq=Indian+Food	7
Nantha Caters	/biz/nantha-caters-scarborough?osq=Indian+Food	9
Pizzaiolo	/biz/pizzaiolo-toronto-16?osq=Indian+Food	115
Bamiyan Kabob	/biz/bamiyan-kabob-east-york?osq=Indian+Food	1
Unity Cafe Corporation	/biz/unity-cafe-corporation-toronto?osq=Indian+Food	2
HaveMore	/biz/havemore-toronto-2?osq=Indian+Food	11
Ropein West Indian Take Out	/biz/ropein-west-indian-take-out-toronto?osq=Indian+Food	1
Bollywood Restaurant	/biz/bollywood-restaurant-woodbridge?osq=Indian+Food	1
Yum Yum Bakery & Pizza	/biz/yum-yum-bakery-and-pizza-toronto?osq=Indian+Food	3
Mirchi Dhaba	/biz/mirchi-dhaba-toronto?osq=Indian+Food	3
New Kwality Refreshments	/biz/new-kwality-refreshments-toronto?osq=Indian+Food	32
Adi Biryani & Kabab House	/biz/adi-biryani-and-kabab-house-toronto?osq=Indian+Food	2
Faley Restaurant	/biz/faley-restaurant-rexdale?osq=Indian+Food	38
Mystik Takeout & Catering	/biz/mystik-takeout-and-catering-scarborough?osq=Indian+Food	18
Jerusalem Restaurant	/biz/jerusalem-restaurant-toronto?osq=Indian+Food	101
Kashmir Curry and Biryani Restaurant	/biz/kashmir-curry-and-biryani-restaurant-etobicoke?osq=Indian+Food	7
MashaAllah	/biz/mashaallah-toronto?osq=Indian+Food	57
Chapati House	/biz/chapati-house-toronto?osq=Indian+Food	17
Kim Kim Indian Hakka Chinese Restaurant	/biz/kim-kim-indian-hakka-chinese-restaurant-scarborough?osq=Indian+Food	17
Biryani Hut	/biz/biryani-hut-toronto?osq=Indian+Food	1
Peppers	/biz/peppers-north-york?osq=Indian+Food	2
Tandoori Queen	/biz/tandoori-queen-toronto?osq=Indian+Food	70
Kandahar Kabab	/biz/kandahar-kabab-toronto?osq=Indian+Food	3
Bangali Sweet House	/biz/bangali-sweet-house-north-york?osq=Indian+Food	3
Moti Palace Sweets Catering	/biz/moti-palace-sweets-catering-toronto?osq=Indian+Food	125
Noor Makkah	/biz/noor-makkah-toronto-2?osq=Indian+Food	22
Federick	/biz/federick-scarborough?osq=Indian+Food	14
Golden Spoon	/biz/golden-spoon-toronto?osq=Indian+Food	4
Noor Makkah	/biz/noor-makkah-toronto?osq=Indian+Food	94
Raw Aura	/biz/raw-aura-mississauga?osq=Indian+Food	5
Indian Airlines	/biz/indian-airlines-toronto?osq=Indian+Food	29
Student Pizza & Curry	/biz/student-pizza-and-curry-north-york?osq=Indian+Food	60
BBQ HUT	/biz/bbq-hut-toronto?osq=Indian+Food	103
Paan Darbaar	/biz/paan-darbaar-toronto?osq=Indian+Food	1
Nagina Karahi	/biz/nagina-karahi-scarborough?osq=Indian+Food	1
Karachi Grill	/biz/karachi-grill-mississauga?osq=Indian+Food	10
Suvaiyakam Restaurant	/biz/suvaiyakam-restaurant-scarborough-2?osq=Indian+Food	8
Nantha Caters	/biz/nantha-caters-toronto-3?osq=Indian+Food	11
Vedic Spice	/biz/vedic-spice-vaughan-2?osq=Indian+Food	1
Capital Sweet And Samosa	/biz/capital-sweet-and-samosa-thorncliffe-park?osq=Indian+Food	72
Zyka Fine Foods & Bbq	/biz/zyka-fine-foods-and-bbq-toronto?osq=Indian+Food	10
Fletch West Indian Restaurant	/biz/fletch-west-indian-restaurant-toronto?osq=Indian+Food	7
Vangi Food	/biz/vangi-food-toronto?osq=Indian+Food	11
Indian Grove Productions	/biz/indian-grove-productions-toronto?osq=Indian+Food	1
Hakka No 1 Restaurant	/biz/hakka-no-1-restaurant-scarborough?osq=Indian+Food	1
Abbirami Catering	/biz/abbirami-catering-scarborough-2?osq=Indian+Food	1
Om India Food Centre	/biz/om-india-food-centre-vaughan-2?osq=Indian+Food	4
Spice Corner	/biz/spice-corner-toronto?osq=Indian+Food	1
Roti Galore	/biz/roti-galore-scarborough?osq=Indian+Food	6
Fusion6 Asian Cuisine	/biz/fusion6-asian-cuisine-woodbridge?osq=Indian+Food	2
Rising Star West Indian Restaurant	/biz/rising-star-west-indian-restaurant-east-york?osq=Indian+Food	3
Pakwanchi Restaurant	/biz/pakwanchi-restaurant-scarborough?osq=Indian+Food	2
New Taste of the West Indian Restaurant	/biz/new-taste-of-the-west-indian-restaurant-york?osq=Indian+Food	51
Naan and Kabob	/biz/naan-and-kabob-scarborough?osq=Indian+Food	1
Fabfood Takeout and Catering	/biz/fabfood-takeout-and-catering-scarborough?osq=Indian+Food	4
Angaara	/biz/angaara-scarborough?osq=Indian+Food	2
Dosa Darbar	/biz/dosa-darbar-etobicoke?osq=Indian+Food	4
Mr Johns Real Kerala Kitchen	/biz/mr-johns-real-kerala-kitchen-scarborough?osq=Indian+Food	2
Imperial Buffet	/biz/imperial-buffet-scarborough?osq=Indian+Food	70
Juicy Jerks West Indian Food Services - CLOSED	/biz/juicy-jerks-west-indian-food-services-north-york?osq=Indian+Food	4
Premium Sweets	/biz/premium-sweets-scarborough?osq=Indian+Food	7
Rich Indian Flavour	/biz/rich-indian-flavour-scarborough?osq=Indian+Food	17
Pizzaiolo	/biz/pizzaiolo-mississauga?osq=Indian+Food	193
Catering King	/biz/catering-king-scarborough?osq=Indian+Food	103
Chola Take Out and Catering	/biz/chola-take-out-and-catering-scarborough?osq=Indian+Food	1
Indian Supermarket Sweets	/biz/indian-supermarket-sweets-scarborough?osq=Indian+Food	1
